.WW..W.W.
.W..W..W.
.W.W.WW..
.W...WW..
..W...WW.
...WW.W..
..W..W.WW
.....W..W
.W.......
